111111
10LT01
101TL1
100001
111111